1111111111111111111111111111111111
1E1000000000001C10000C000000000001
1010010100100000111000000000010101
1010010010111111000000100000001011
1000000110C00C000P00000000000000C1
1111111111111111111111111111111111